0000000000
0004440000
0004440000
0004440000
0000000000
0000001000